wwwwwwwwwwwwwwwwwwwwwwwwwwww
wiiiiiiiiiiiiiiiiiiiiiiiiiiw
w.....__........._....._...w
w.......x........x......x..w
w.....x........x......x....w
w.......l........l......l..w
w++++++++++++++++++++++++++w
w+t+++tt+++ttt+t++ttt++ttt+w
wx......x........x......x..w
w..l......l........l......lw
wl......l........l......l..w
w+++tttttttttttttttt++ttt++w
w++++++++++ttttttt+++++++++w
w.l......l................lw
w++++++++++++S+++++++++++++w
wwwwwwwwwwwwwwwwwwwwwwwwwwww
